






NO ./images/crate.png
SO ./images/crate2.png
WE ./images/crate3.png
EA ./images/crate4.png
SP ./images/tile_0089.png,./images/tile_0090.png,./images/tile_0091.png,./images/tile_0092.png,./images/tile_0091.png
DO ./images/door.png

F 0,210,234
C 255,165,0


11111111111111111111111111111111111111111111111111111
1EX0000000P0XXXXXXXXXXXXXXXXXXXXXXXXXXXXXXXXXX000XX11
10X00000001XPXXXXXXXXXXXXXXXXXXXXXXXXXXXXXXXXX000XX11
10X00000001XPXXXXXXXXXXXXXXXXXXXXXXXXXXXXXXXXX00X0X11
10X00000001XPXXXXXXXXXXXXXXXXXXXXXXXXXXXXXXXXX00X0X11
10X0000000PXPXXXXXXXXXXXXXXXXXXXXXXXXXXXXXXXXX00X0X11
11111111111111111111111111111111111111111111111111111
