






NO ./images/crate.png
SO ./images/crate2.png
WE ./images/crate3.png
EA ./images/crate4.png
SP ./images/tile_0089.png,./images/tile_009Xs.png,./images/tile_0091.png,./images/tile_0092.png,./images/tile_0091.png
DO ./images/door.png

F 0,210,234
C 255,165,0


11111111111111111111111111111111111111111111111111111
1EX0000000P0000000100000000000000000000000000X000XX11
10X00000001XP000000100000000000000000000000000000XX11
10X00000001XP00000010000000000000000000000000000X0X11
10X0000000PXPXXXXXXXXXXXXXXXXXXXXXXXXXXXXXXXXX00X0X11
11111111111111111111111111111111111111111111111111111
