






NO ./images/crate.png
SO ./images/crate2.png
WE ./images/crate3.png
EA ./images/crate4.png

C 225,30,0

111111111111111111111
10000000011W000000001
100000001100000000011
111111111111111111111
